-------------------------
-------------------------
--------XXXXXXXXX--------
-------------------------
----W---------------W----
-----MXXZMXXXXXMZXXM-----
-----H---H-----H---H-----
---W-H---H-----H---H-W---
----MXXXZXXXMXXXZXXXM----
----H-------H-------H----
--W-H-------H-------H-W--
---MXXXXZXMXXXMXZXXXXM---
---H------H---H------H---
-W-H------H---H------H-W-
--MXXXXXZXXXMXXXZXXXXXM--
--H---------H---------H--
W-H---------H---------H-W
-XXXXXXXXXXXXXXXXXXXXXXX-